1111111111
1000100011
1000101011
10011010C1
10011000N1
1010001001
11100010P1
1010000011
1111111111
