1111111111111
1P01000000001
1001011111001
1000010000001
1111111111111
