1111111111111
10010C00001C1
1000011101011
1P0011E000001
1111111111111