1111111111111
1001000000001
1000011111001
1P0011E0000F1
1111111111111