111111111111111111111111111111111111111
10010000000C000000000000000000000000001
100001111100000000000000000000000000001
1P00110E000000N000000000000000000000001
100N00000000000000000000000000000000001
1000C1110000000000000000000000000000001
10000101000N000000000000000000000000001
100001110000000000000000000000000000001
100N00100000000000000000000000000000001
1N00001C0000000000000000000000000000001
100111101100000000000000000000000000001
100000100000000000000000000000000000001
100000100000000000000000000000000000001
1000001C0010000000000000000000000000001
100000110000000000000000000000000000001
1C0000000000000000000000000000000000001
111111110000000000000000000000000000001
1C0000000000000000000000000000000000001
10000N11110C000000000000000000000000001
10000011110C000000000000000000000000001
111111111111111111111111111111111111111